ABCDABCDABCDABCDABCDABCDABCDABCDABCDABCDABCDABCDABCDABCDABCD
EFGHEFGHEFGHEFGHEFGHEFGHEFGHEFGHEFGHEFGHEFGHEFGHEFGHEFGHEFGH
IJKLIJKLIJKLIJKLIJKLIJKLIJKLIJKLIJKLIJKLIJKLIJKLIJKLIJKLIJKL
MNOPMNOPMNOPMNOPMNOPMNOPMNOPMNOPMNOPMNOPMNOPMNOPMNOPMNOPMNOP
............ABCD............................................
............EFGH............................................
............IJKL............................................
............MNOP............................................
............ABCD........ABCDABCDABCD........................
............EFGH........EFGHEFGHEFGH........................
............IJKL........IJKLIJKLIJKL........................
............MNOP........MNOPMNOPMNOP........................
............ABCD........ABCD....ABCDABCDABCD....ABCD....ABCD
............EFGH........EFGH....EFGHEFGHEFGH....EFGH....EFGH
............IJKL........IJKL....IJKLIJKLIJKL....IJKL....IJKL
............MNOP........MNOP....MNOPMNOPMNOP....MNOP....MNOP
............ABCD....................ABCD....................
............EFGH....................EFGH....................
............IJKL....................IJKL....................
............MNOP....................MNOP....................
ABCDABCDABCDABCDABCDABCD....ABCDABCDABCDABCDABCD....ABCDABCD
EFGHEFGHEFGHEFGHEFGHEFGH....EFGHEFGHEFGHEFGHEFGH....EFGHEFGH
IJKLIJKLIJKLIJKLIJKLIJKL....IJKLIJKLIJKLIJKLIJKL....IJKLIJKL
MNOPMNOPMNOPMNOPMNOPMNOP....MNOPMNOPMNOPMNOPMNOP....MNOPMNOP
__,,,,,,...................ABCD.........................ABCD
__,,,,,,...................EFGH.........................EFGH
__,,,,,,...................IJKL.........................IJKL
__,,,,,,...................MNOP.........................MNOP
ABCDABCDABCDABCDABCDABCD....ABCDABCDABCDABCDABCD....ABCDABCD
EFGHEFGHEFGHEFGHEFGHEFGH....EFGHEFGHEFGHEFGHEFGH....EFGHEFGH
IJKLIJKLIJKLIJKLIJKLIJKL....IJKLIJKLIJKLIJKLIJKL....IJKLIJKL
MNOPMNOPMNOPMNOPMNOPMNOP....MNOPMNOPMNOPMNOPMNOP....MNOPMNOP
............ABCD....................ABCD....................
............EFGH....................EFGH....................
............IJKL....................IJKL....................
............MNOP....................MNOP....................
............ABCD........ABCD....ABCDABCDABCD....ABCD....ABCD
............EFGH........EFGH....EFGHEFGHEFGH....EFGH....EFGH
............IJKL........IJKL....IJKLIJKLIJKL....IJKL....IJKL
............MNOP........MNOP....MNOPMNOPMNOP....MNOP....MNOP
............ABCD........ABCDABCDABCD........................
............EFGH........EFGHEFGHEFGH........................
............IJKL........IJKLIJKLIJKL........................
............MNOP........MNOPMNOPMNOP........................
............ABCD............................................
............EFGH............................................
............IJKL............................................
............MNOP............................................
ABCDABCDABCDABCDABCDABCDABCDABCDABCDABCDABCDABCDABCDABCDABCD
EFGHEFGHEFGHEFGHEFGHEFGHEFGHEFGHEFGHEFGHEFGHEFGHEFGHEFGHEFGH
IJKLIJKLIJKLIJKLIJKLIJKLIJKLIJKLIJKLIJKLIJKLIJKLIJKLIJKLIJKL
MNOPMNOPMNOPMNOPMNOPMNOPMNOPMNOPMNOPMNOPMNOPMNOPMNOPMNOPMNOP
